S___#___+
_##-__##$
_##______
_##~_##__
_______##
_$__$__$#