#####################################
S___________________________________#
##########_##################_#######
##########_##################$#######
##########_##################_#######
#########___#_________________#######
#########_#_#_#######################
#########~#_#_______________________#
#########_#_#######################_#
#########_#_#_______________________#
+_________#_#_#####################-#
___________#________________$_______#
##########___########################